NO ./assets/textures/eaglelight_64.xpm
SO ./assets/textures/eagledark_64.xpm
EA ./assets/textures/hitlerdark_64.xpm
WE ./assets/textures/hitlerlight_64.xpm

C 0,40,80
F 90,90,90

1111111111111111111111111
1111100000E00000000111111
1111111111111111111111111
