NO ./path_to_the_north_texture
SO ./path_to_the_south_texture
WE ./path_to_the_west_texture
EA ./path_to_the_east_texture
C 225,30,0
F 225,50,0


      1111
    111001
    100N01
   1100001
1111001111 1111
1000000001 1001
100111000111001
111111111111111

111111111111111
1001 1000000001111111
100111000000000000011
10000000011111111111
1111111111
101
111

