NO ./assets/textures/eagledark_64.xpm
EA ./assets/textures/eaglelight_64.xpm
WE ./assets/textures/hitlerlight_64.xpm
SO ./assets/textures/hitlerdark_64.xpm

Z 0,40,80
F 90,90,90

        1111111111111111111111111
        1000000000110000000000001
        1011000001110000000000001
        1001000001110000000000001
111111111011000001 10000000000001
100000000011000001110111111111111
11110111111111011100000010001
11110111111111011101010010011
11000000110101011100000010001
100N0000000000000110000001101
10000000000000001101010010001
11000001110101011111011110011
11110111 1110101 101111010001
11111111 1111111 111111111111
