NO ./assets/textures/grey_bricks1.xpm
EA ./assets/textures/eagle_dark.xpm
WE ./assets/textures/hitler_dark.xpm
SO ./assets/textures/grey_bricks2.xpm

C 0,40,80
F 90,90,90

l

111111111111111111111111
100000000000000111111111
101100000000000000000001
100100000000000000000001
110000N00000000000000001
100000000000000000000001
111111111111111111111111



