NO ./assets/textures/bricks_128.xpm
SO ./assets/textures/eagledark_64.xpm
EA ./assets/textures/redwood_128.xpm
WE ./assets/textures/hitlerlight_64.xpm

C 0,180,80
F 90,90,90

11111111111111111
10E01111111000001
10001111111000001
10001111111000001
10001111111000001
10001111111000001
10001111111000001
10001111111000001
10001111111000001
10001111111000001
10011111110000001
10000000000000001
11111111111111111