NO ./path_to_the_north_texture
SO ./path_to_the_south_texture
WE ./path_to_the_west_texture
EA ./path_to_the_east_texture

F 225,50,0
C 225,30,0

111111
100001
1000S1
100001
100001
111111



