NO ./path_to_the_north_texture
SO ./path_to_the_south_texture
WE ./path_to_the_west_texture
EA ./path_to_the_east_texture

F 225,50,0
C 225,30,0

11 1111
1010001
1000N01
1010001
1111111