NO ./path_to_the_north_texture
SO ./path_to_the_south_texture
WE ./path_to_the_west_texture
EA ./path_to_the_east_texture

F 225,50,0
C 225,30,0

      1111
    111001
    100001
   1100001
1000001111 1111
1000000001 1001
100000000111001
100000N00000001111111
100000000000001000011
10000000011111111111
1111111111
101
111